NO walls/blue_tex.png
SO walls/red_tex.png
WE walls/green_tex.png
EA walls/yellow_tex.png

C 000,000,000
F 255,255,255

        111111111111111111111111
        1000000000110000000000001
        1011000001110000000000001
        100100000000000000S000001
111111111011000001110000000000001
100000000011000001110111111111111
11110111111111011100000010001
11110111111111011101010010001 
11000000110101011100000000001
1000000000000001100000010001
10000000000000001101010010001
110000011101010111110111100111
11110111 1110101 1 1111010001
11111111 1111111 111111111111
